11111111111111111111
1P000000000000000001
10111111110111111111
1010000101M0C0000001
10001100010101111101
11111111010101E00001
11000000000101111111
10011111111101100001
101C0000010000001101
10101011000111101101
100010000100000000C1
11111111111111111111
