111111111
1000000C1
10C0000M1
1000P0001
1M0000001
1C000E001
111111111