111111111
1000000C1
10C000001
1000P0001
110000001
1C100E001
111111111