1111111111111111111111111111111111111
1PC0000000000000000000000000000000001
1000000000000000000000000000000000001
1000000000000000000C00000000000000001
1000000000000000000000000000000000001
10000000000000000000000000000000000E1
1111111111111111111111111111111111111