11111111111111111111
1P0000011C0000000001
11101101111111111001
10101101000000000001
10001101001111111001
11111001001E00000001
1000C011001111011111
101111110000110000C1
10101111111011111101
100000000C0000000001
11111111111111111111