11111111111111
1P0000000000E1
11100000000001
1C101111100011
111001000001X1
10001C10000011
11111111111111