11111111111111
1P0000000000E1
1C000000000001
10001111100001
100000000000X1
10000C00000001
11111111111111
11111111111111
11111111111111
11111111111111
11111111111111
11111111111111
11111111111111
llegahastaaqui