111111111
1000000C1
10C000001
1000P0001
100000001
1C000E001
111111111